Rk,Team,G,MP,FG,FGA,FG%,3P,3PA,3P%,2P,2PA,2P%,FT,FTA,FT%,ORB,DRB,TRB,AST,STL,BLK,TOV,PF,PTS
1,Golden State Warriors,82,19705,3489,7208,0.484,243,750,0.324,3246,6458,0.503,2313,2858,0.809,915,2385,3300,1978,756,488,1415,2010,9534
2,Phoenix Suns*,82,19855,3544,7139,0.496,176,543,0.324,3368,6596,0.511,2159,2716,0.795,1053,2651,3704,2109,668,501,1275,1825,9423
3,Denver Nuggets*,82,19805,3716,8015,0.464,228,677,0.337,3488,7338,0.475,1737,2201,0.789,1169,2532,3701,2275,814,329,1136,2047,9397
4,Portland Trail Blazers*,82,19880,3572,7547,0.473,190,565,0.336,3382,6982,0.484,2031,2734,0.743,1355,2552,3907,2085,749,364,1356,2048,9365
5,Orlando Magic,82,19805,3457,7525,0.459,116,393,0.295,3341,7132,0.468,2060,2725,0.756,1304,2465,3769,1993,617,294,1407,1975,9090
6,Los Angeles Lakers*,82,19855,3434,7010,0.49,309,841,0.367,3125,6169,0.507,1902,2417,0.787,1097,2460,3557,2232,655,445,1226,1737,9079
7,Philadelphia 76ers*,82,19805,3437,7028,0.489,189,543,0.348,3248,6485,0.501,1976,2509,0.788,1111,2406,3517,1932,687,365,1209,1697,9039
8,Boston Celtics*,82,19705,3563,7148,0.498,106,404,0.262,3457,6744,0.513,1791,2153,0.832,1066,2707,3773,2423,539,455,1256,1717,9023
9,Chicago Bulls*,82,19830,3531,7090,0.498,250,669,0.374,3281,6421,0.511,1665,2140,0.778,1075,2279,3354,2172,814,388,1247,1906,8977
10,Indiana Pacers*,82,19880,3381,6807,0.497,294,770,0.382,3087,6037,0.511,1906,2335,0.816,940,2388,3328,2023,552,350,1342,1972,8962
11,Atlanta Hawks,82,19730,3417,7019,0.487,124,411,0.302,3293,6608,0.498,1943,2544,0.764,1273,2187,3460,1820,717,353,1270,1871,8901
12,New York Knicks*,82,19830,3434,7089,0.484,236,710,0.332,3198,6379,0.501,1775,2349,0.756,1187,2426,3613,2140,714,492,1412,1828,8879
13,Washington Bullets,82,19830,3598,7581,0.475,37,197,0.188,3561,7384,0.482,1599,2093,0.764,1198,2450,3648,2214,561,424,1201,1929,8832
14,Seattle SuperSonics,82,19905,3466,7243,0.479,231,650,0.355,3235,6593,0.491,1606,2167,0.741,1323,2255,3578,1874,701,335,1336,2064,8769
15,Utah Jazz*,82,19830,3330,6593,0.505,226,630,0.359,3104,5963,0.521,1874,2484,0.754,953,2501,3454,2212,677,491,1410,2031,8760
16,Houston Rockets*,82,19805,3483,7250,0.48,153,491,0.312,3330,6759,0.493,1633,2267,0.72,1217,2638,3855,2194,809,551,1513,1934,8752
17,San Antonio Spurs*,82,19730,3388,6997,0.484,54,226,0.239,3334,6771,0.492,1888,2535,0.745,1163,2474,3637,2037,799,554,1399,1854,8718
18,Milwaukee Bucks*,82,19830,3380,7146,0.473,209,670,0.312,3171,6476,0.49,1722,2273,0.758,1108,2246,3354,2046,826,326,1315,2086,8691
19,Detroit Pistons*,82,19805,3333,6980,0.478,177,541,0.327,3156,6439,0.49,1713,2252,0.761,1185,2458,3643,1996,512,418,1233,1961,8556
20,Los Angeles Clippers,82,19805,3319,6853,0.484,56,230,0.243,3263,6623,0.493,1815,2458,0.738,1056,2362,3418,1978,782,507,1547,1859,8509
21,Cleveland Cavaliers*,82,19880,3214,6977,0.461,346,851,0.407,2868,6126,0.468,1637,2201,0.744,1128,2380,3508,2106,645,512,1243,1666,8411
22,Dallas Mavericks*,82,19855,3246,6831,0.475,157,486,0.323,3089,6345,0.487,1735,2261,0.767,1042,2419,3461,1776,664,398,1228,1733,8384
23,Sacramento Kings,82,19755,3305,7056,0.468,216,649,0.333,3089,6407,0.482,1515,1964,0.771,952,2363,3315,2052,546,392,1239,1863,8341
24,Miami Heat,82,19730,3383,7345,0.461,88,300,0.293,3295,7045,0.468,1393,2028,0.687,1242,2313,3555,1957,736,388,1557,2123,8247
25,Charlotte Hornets,82,19755,3270,7183,0.455,205,611,0.336,3065,6572,0.466,1487,1967,0.756,962,2211,3173,2080,778,262,1226,1889,8232
26,New Jersey Nets,82,19705,3157,7415,0.426,140,506,0.277,3017,6909,0.437,1754,2350,0.746,1363,2324,3687,1475,774,481,1360,1952,8208
27,Minnesota Timberwolves,82,19855,3067,6876,0.446,73,294,0.248,2994,6582,0.455,1596,2137,0.747,1196,2053,3249,1844,789,344,1197,1901,7803
,League Average,82,19806,3404,7146,0.476,179,541,0.331,3225,6605,0.488,1786,2338,0.764,1135,2403,3538,2038,699,415,1317,1907,8773